./gfx/test.png
40 10
20 20
####################
#..................#
#..................#
#..................#
#..########........#
#.........#........#
#.........#........#
#.........#........#
#.........#........#
#.........#........#
#.........#........#
#.........#........#
#.........#........#
#.........#........#
#.........#........#
#....######........#
#..................#
#..................#
#..................#
####################
