./gfx/test.png
20 20
0:2 0:2 0:2 0:2 0:2 0:2 0:2 0:2 0:2 0:2 0:2 0:2 0:2 0:2 0:2 0:2 0:2 0:2 0:2 0:2
0:2 1:1 1:1 1:1 1:1 1:1 1:1 1:1 1:1 1:1 1:1 1:1 1:1 1:1 1:1 1:1 1:1 1:1 1:1 0:2
0:2 1:1 1:1 1:1 1:1 1:1 1:1 1:1 1:1 1:1 1:1 1:1 1:1 1:1 1:1 1:1 1:1 1:1 1:1 0:2
0:2 1:1 1:1 1:1 1:1 1:1 1:1 1:1 1:1 1:1 1:1 1:1 1:1 1:1 1:1 1:1 1:1 1:1 1:1 0:2
0:2 1:1 1:1 0:2 0:2 0:2 0:2 0:2 0:2 0:2 0:2 1:1 1:1 1:1 1:1 1:1 1:1 1:1 1:1 0:2
0:2 1:1 1:1 1:1 1:1 1:1 1:1 1:1 1:1 1:1 0:2 1:1 1:1 1:1 1:1 1:1 1:1 1:1 1:1 0:2
0:2 1:1 1:1 1:1 1:1 1:1 1:1 1:1 1:1 1:1 0:2 1:1 1:1 1:1 1:1 1:1 1:1 1:1 1:1 0:2
0:2 1:1 1:1 1:1 1:1 1:1 1:1 1:1 1:1 1:1 0:2 1:1 1:1 1:1 1:1 1:1 1:1 1:1 1:1 0:2
0:2 1:1 1:1 1:1 1:1 1:1 1:1 1:1 1:1 1:1 0:2 1:1 1:1 1:1 1:1 1:1 1:1 1:1 1:1 0:2
0:2 1:1 1:1 1:1 1:1 1:1 1:1 1:1 1:1 1:1 0:2 1:1 1:1 1:1 1:1 1:1 1:1 1:1 1:1 0:2
0:2 1:1 1:1 1:1 1:1 1:1 1:1 1:1 1:1 1:1 0:2 1:1 1:1 1:1 1:1 1:1 1:1 1:1 1:1 0:2
0:2 1:1 1:1 1:1 1:1 1:1 1:1 1:1 1:1 1:1 0:2 1:1 1:1 1:1 1:1 1:1 1:1 1:1 1:1 0:2
0:2 1:1 1:1 1:1 1:1 1:1 1:1 1:1 1:1 1:1 0:2 1:1 1:1 1:1 1:1 1:1 1:1 1:1 1:1 0:2
0:2 1:1 1:1 1:1 1:1 1:1 1:1 1:1 1:1 1:1 0:2 1:1 1:1 1:1 1:1 1:1 1:1 1:1 1:1 0:2
0:2 1:1 1:1 1:1 1:1 1:1 1:1 1:1 1:1 1:1 0:2 1:1 1:1 1:1 1:1 1:1 1:1 1:1 1:1 0:2
0:2 1:1 1:1 1:1 1:1 0:2 0:2 0:2 0:2 0:2 0:2 1:1 1:1 1:1 1:1 1:1 1:1 1:1 1:1 0:2
0:2 1:1 1:1 1:1 1:1 1:1 1:1 1:1 1:1 1:1 1:1 1:1 1:1 1:1 1:1 1:1 1:1 1:1 1:1 0:2
0:2 1:1 1:1 1:1 1:1 1:1 1:1 1:1 1:1 1:1 1:1 1:1 1:1 1:1 1:1 1:1 1:1 1:1 1:1 0:2
0:2 1:1 1:1 1:1 1:1 1:1 1:1 1:1 1:1 1:1 1:1 1:1 1:1 1:1 1:1 1:1 1:1 1:1 1:1 0:2
0:2 0:2 0:2 0:2 0:2 0:2 0:2 0:2 0:2 0:2 0:2 0:2 0:2 0:2 0:2 0:2 0:2 0:2 0:2 0:2
buggy 6 9 12 9