./gfx/test.png
10 12
1:1 1:1 1:1 1:1 1:1 1:1 1:1 1:1 1:1 1:1
1:1 1:1 1:1 1:1 1:1 1:1 1:1 1:1 1:1 1:1
1:1 1:1 1:1 1:1 1:1 1:1 1:1 1:1 1:1 1:1
1:1 1:1 0:2 0:2 0:2 1:1 1:1 1:1 1:1 1:1
1:1 1:1 1:1 1:1 0:2 1:1 1:1 1:1 1:1 1:1
1:1 1:1 1:1 1:1 0:2 1:1 1:1 1:1 1:1 1:1
1:1 1:1 1:1 1:1 0:2 1:1 1:1 1:1 1:1 1:1
1:1 1:1 1:1 1:1 0:2 1:1 1:1 1:1 1:1 1:1
1:1 1:1 1:1 0:2 0:2 0:2 0:2 0:2 1:1 1:1
1:1 1:1 1:1 1:1 1:1 1:1 1:1 1:1 1:1 1:1
1:1 1:1 1:1 1:1 1:1 1:1 1:1 1:1 1:1 1:1
1:1 1:1 1:1 1:1 1:1 1:1 1:1 1:1 1:1 1:1
