./gfx/test.png
40 10
20 20
0:2 0:2 0:2 0:2 0:2 0:2 0:2 0:2 0:2 0:2 0:2 0:2 0:2 0:2 0:2 0:2 0:2 0:2 0:2 0:2
0:2 1:1 1:1 1:1 0:2 1:1 1:1 1:1 1:1 1:1 1:1 1:1 1:1 1:1 1:1 1:1 1:1 1:1 1:1 0:2
0:2 1:1 1:1 1:1 0:2 1:1 1:1 1:1 1:1 0:2 1:1 1:1 1:1 1:1 1:1 1:1 1:1 1:1 1:1 0:2
0:2 1:1 1:1 1:1 0:2 1:1 1:1 1:1 0:2 0:2 1:1 1:1 1:1 1:1 1:1 1:1 1:1 1:1 1:1 0:2
0:2 1:1 1:1 1:1 0:2 0:2 0:2 0:2 0:2 1:1 1:1 1:1 1:1 1:1 1:1 1:1 1:1 1:1 1:1 0:2
0:2 1:1 1:1 1:1 1:1 1:1 0:2 1:1 1:1 1:1 1:1 1:1 1:1 0:2 1:1 1:1 1:1 1:1 1:1 0:2
0:2 1:1 1:1 1:1 1:1 1:1 0:2 1:1 1:1 1:1 1:1 0:2 0:2 0:2 1:1 1:1 1:1 1:1 1:1 0:2
0:2 1:1 1:1 1:1 1:1 1:1 0:2 1:1 1:1 1:1 1:1 1:1 1:1 0:2 1:1 1:1 1:1 1:1 1:1 0:2
0:2 1:1 1:1 1:1 1:1 1:1 0:2 1:1 1:1 1:1 1:1 1:1 1:1 0:2 1:1 1:1 1:1 1:1 1:1 0:2
0:2 1:1 1:1 1:1 1:1 1:1 0:2 1:1 1:1 1:1 1:1 1:1 1:1 0:2 1:1 1:1 1:1 1:1 1:1 0:2
0:2 1:1 1:1 1:1 1:1 0:2 0:2 0:2 0:2 0:2 0:2 0:2 0:2 0:2 0:2 0:2 0:2 1:1 1:1 0:2
0:2 1:1 1:1 1:1 1:1 0:2 1:1 1:1 1:1 1:1 1:1 1:1 1:1 0:2 1:1 1:1 1:1 1:1 1:1 0:2
0:2 1:1 1:1 1:1 1:1 0:2 1:1 1:1 1:1 1:1 1:1 1:1 1:1 0:2 1:1 1:1 1:1 1:1 1:1 0:2
0:2 1:1 1:1 1:1 1:1 0:2 1:1 1:1 1:1 0:2 0:2 0:2 0:2 0:2 0:2 0:2 0:2 1:1 1:1 0:2
0:2 1:1 1:1 1:1 1:1 1:1 1:1 1:1 1:1 0:2 1:1 1:1 1:1 1:1 1:1 1:1 1:1 1:1 1:1 0:2
0:2 1:1 1:1 1:1 1:1 0:2 0:2 0:2 0:2 0:2 0:2 0:2 0:2 0:2 1:1 1:1 1:1 0:2 1:1 0:2
0:2 1:1 1:1 1:1 1:1 0:2 1:1 1:1 1:1 1:1 1:1 1:1 1:1 1:1 1:1 1:1 1:1 0:2 1:1 0:2
0:2 1:1 1:1 1:1 0:2 0:2 0:2 0:2 0:2 0:2 1:1 1:1 1:1 0:2 0:2 0:2 0:2 0:2 1:1 0:2
0:2 1:1 1:1 1:1 1:1 1:1 1:1 1:1 1:1 1:1 1:1 1:1 1:1 1:1 1:1 1:1 1:1 1:1 1:1 0:2
0:2 0:2 0:2 0:2 0:2 0:2 0:2 0:2 0:2 0:2 0:2 0:2 0:2 0:2 0:2 0:2 0:2 0:2 0:2 0:2
buggy 2 2 11 8