./gfx/tiles.png
16
20 20
####################
#...#..............#
#...#....#.........#
#...#...##.........#
#...#####..........#
#.....#......#.....#
#.....#....###.....#
#.....#......#.....#
#.....#......#.....#
#.....#......#.....#
#....############..#
#....#.......#.....#
#....#.......#.....#
#....#...########..#
#........#.........#
#....#########...#.#
#....#...........#.#
#...######...#####.#
#..................#
####################