./gfx/tiles.png
16
9 7
#########
#.......#
#...#...#
#...#...#
#...#...#
#.......#
#########
